#########################################
          ###############################
######### ###############################
######### ###############################
######### ###############################
######### ###############################
#########       #########################
############### #########################
############### #########################
############### #########################
#########                               #
######################## ################
######################## ##########     #
######################## ########## ### #
######################## ########## ### #
########################            ### #
#######################################  
#########################################